+--+--+--+--+--+--+--+--+--+--+
|             S|     |     |  |
+  +--+--+--+  +--+  +  +  +  +
|     |  |     |     |  |  |  |
+--+  +  +  +--+  +--+--+  +  +
|     |  |        |     |     |
+  +--+  +--+--+--+  +  +  +--+
|     |        |     |        |
+--+  +--+  +  +  +--+--+--+  +
|  |  |  |  |     |           |
+  +  +  +  +--+--+  +--+--+--+
|           |     |        |  |
+--+  +--+--+  +--+--+--+  +  +
|     |        |     |     |  |
+  +--+  +--+  +  +--+  +--+  +
|  |     |  |  |     |      F |
+  +  +--+  +  +--+  +--+--+  +
|  |  |     |     |  |     |  |
+  +  +  +--+--+  +  +  +--+  +
|     |              |        |
+--+--+--+--+--+--+--+--+--+--+
